Stage 1
#####
#OoP#
#####
=====
Stage 1`
#####
#OoP#
#####
=====
Stage 2
  #######
###  O  ###
#    o    #
# Oo P oO #
###  o  ###
 #   O  #
 ########
====
Stage 3
######
#  P #
#o####
# #
#O#
###
====
Stage 4
######
#P   #
#  oO#
# Oo #
######
====
Stage 5
#####
#P  ##
#Oo0 #
#  # #
#    #
######